18 14
##################
#                #
#   ########     #
#   #########    #
#   ######### 2# #
#   ############ #
#   #####        #
#   ############ #
#     #          #
#     ########   #
#    ##          #
#    #########   #
#           1#   #
##################
