16 15
###############
#    #        #
#           # #
#       #     #
# # # #####   #
#         #   #
#         #   #
#  ##  #  ##  #
#   #         #
#   #         #
#   ##### # # #
#     #       #
# #           #
#        #    #
###############